19 19 18 18 19 18 18 18 18 18 18 18 18 19 18 18 18 18 18 18 18 18 18 18 18 18 18 18 18 18 19 18 18 18 18 18 18 18 18 18 19 18 18 18 18 18 19 19 18 18 
18 18 18 18 18 18 18 18 18 18 18 18 19 18 18 18 18 18 18 18 18 18 18 18 18 18 18 18 18 18 18 18 18 18 18 18 18 18 18 18 18 18 19 18 18 18 18 18 18 18 
18 18 18 18 18 18 18 18 18 18 18 18 18 18 18 18 19 18 18 18 18 18 18 18 18 18 18 18 19 18 18 18 18 19 18 18 18 19 18 18 18 18 18 18 18 18 19 18 18 18 
19 18 18 18 18 18 18 19 18 18 18 19 18 18 18 18 18 18 18 18 18 19 18 18 18 18 18 18 18 18 18 18 18 18 18 18 18 18 18 18 18 18 18 18 18 18 18 18 18 18 
18 18 18 18 18 18 18 18 18 18 18 18 18 18 18 18 18 18 18 19 18 18 18 18 18 18 18 18 18 18 18 18 18 18 18 18 18 18 18 18 18 18 18 18 18 18 18 18 18 18 
18 18 18 18 18 18 18 18 18 18 18 18 18 18 18 18 18 18 18 18 18 18 18 18 18 18 18 18 18 18 18 18 18 18 18 18 18 18 18 18 18 18 18 18 18 18 18 18 18 18 
18 18 18 18 18 18 18 18 18 18 18 18 18 18 18 18 18 18 18 18 18 18 18 18 18 18 19 18 18 18 18 18 18 19 18 18 18 18 18 18 18 18 18 18 18 18 18 18 18 18 
19 18 18 18 18 18 18 18 18 18 18 18 18 18 18 18 18 18 18 18 18 18 18 18 18 18 18 18 18 18 18 18 19 18 18 19 18 18 18 18 19 18 18 18 18 18 18 18 18 18 
18 18 19 18 18 19 18 18 18 18 28 26 26 26 26 26 26 26 26 26 26 26 26 26 26 26 26 26 26 26 26 26 26 26 26 26 26 26 18 18 18 18 18 19 18 18 18 18 18 18 
18 18 18 18 18 18 18 18 18 26 27 16 16 16 16 16 16 16 16 16 16 16 16 16 16 16 16 16 16 16 16 16 16 16 16 16 16 16 23 18 18 18 18 18 18 18 18 18 18 18 
18 18 18 18 18 18 18 18 24 16 16 1 1 1 1 1 1 1 1 16 16 16 16 16 16 16 16 16 16 16 1 16 16 16 16 16 16 16 25 26 26 26 18 18 18 18 18 18 18 18 
18 18 18 18 18 18 18 19 24 16 16 1 16 16 16 16 16 16 16 16 16 16 16 16 16 16 16 16 16 16 1 16 16 16 16 1 16 16 16 40 38 41 23 18 18 18 18 19 18 18 
19 18 18 18 18 18 19 28 27 3 3 3 16 16 16 16 16 16 16 16 16 16 16 16 16 16 16 1 16 16 1 1 16 16 16 2 2 16 16 43 39 42 23 19 18 18 18 18 18 18 
19 18 18 18 18 18 18 24 16 3 3 3 16 16 16 16 16 16 16 16 16 16 16 16 16 16 1 16 16 16 1 16 16 16 16 1 1 1 1 1 1 2 23 18 18 19 18 18 18 18 
18 18 18 18 18 18 18 24 16 3 3 3 3 3 16 16 16 16 16 16 16 16 1 1 1 1 1 1 1 2 1 2 1 1 16 1 1 1 1 1 20 21 31 18 18 18 18 18 18 18 
18 18 18 18 18 18 18 24 16 3 3 3 3 3 3 3 3 3 3 1 1 1 1 1 1 2 2 1 1 1 1 1 16 1 1 1 1 1 2 16 25 29 18 18 18 18 18 18 18 18 
18 18 18 18 19 18 18 24 16 3 3 3 3 3 3 3 3 3 3 16 16 16 1 1 1 1 1 1 1 1 1 1 1 1 1 1 1 16 16 16 16 23 18 18 18 19 18 18 18 18 
18 18 18 18 18 18 18 24 16 16 16 16 16 16 16 16 16 3 3 16 16 16 16 16 1 1 1 2 1 1 1 1 1 1 1 1 2 16 16 16 16 23 18 18 18 18 18 19 18 19 
19 18 18 18 18 18 18 24 16 16 16 16 16 3 3 3 3 3 16 16 16 16 16 16 16 1 1 1 1 1 1 16 1 1 1 16 16 16 16 16 16 23 19 18 18 18 18 18 18 18 
18 18 18 18 18 18 18 24 16 16 16 16 16 3 16 16 16 3 16 16 16 16 16 16 16 1 16 1 1 1 1 1 16 16 16 16 16 16 16 16 16 23 18 18 18 18 18 18 18 18 
18 18 18 18 18 18 18 24 16 16 16 16 16 3 16 16 16 3 16 16 16 16 16 16 16 16 16 16 16 16 16 16 16 16 16 16 16 16 16 16 16 25 29 18 18 18 18 18 18 18 
19 18 18 18 18 18 18 24 16 16 16 16 16 3 16 16 16 3 16 16 16 16 16 16 16 16 16 16 16 16 16 16 16 3 3 3 3 3 16 16 16 16 23 18 18 18 18 18 18 19 
18 18 18 18 18 18 19 24 16 16 16 16 16 3 3 3 3 3 16 16 16 16 16 16 16 16 16 16 16 16 16 16 3 3 3 3 3 3 16 16 16 16 23 19 18 18 18 18 18 19 
18 18 18 18 18 18 18 24 16 16 16 16 16 3 16 16 16 16 16 16 16 16 16 16 16 16 16 16 16 16 16 16 16 16 16 16 3 3 3 3 16 16 23 18 18 18 18 18 18 18 
18 18 18 18 18 18 18 24 16 16 16 16 16 3 16 16 16 16 16 16 16 16 16 16 16 16 16 16 16 16 16 16 16 16 16 16 3 3 3 3 16 16 23 18 18 18 18 18 18 18 
18 18 18 18 18 18 18 24 16 16 16 16 16 3 16 16 16 16 16 16 2 1 1 2 1 2 1 1 2 2 2 16 16 16 16 16 16 16 3 3 16 16 23 19 18 18 18 18 18 18 
18 18 18 18 18 18 18 24 16 16 16 16 16 3 16 16 16 16 16 16 1 1 1 1 1 1 1 1 1 1 1 16 16 16 16 16 16 16 16 3 16 16 23 18 18 18 18 18 18 18 
18 18 18 18 18 19 18 24 16 16 16 16 16 3 16 16 16 16 16 16 2 1 1 1 1 1 1 1 1 1 2 16 16 16 16 16 16 16 16 3 16 16 23 18 18 18 18 18 18 18 
19 18 18 18 18 18 18 24 16 16 16 16 16 3 16 16 16 16 16 16 16 2 1 2 1 2 2 2 2 2 16 16 16 16 16 16 16 16 16 3 16 16 23 18 18 18 18 18 18 18 
19 18 18 18 18 18 18 24 16 16 16 16 16 3 16 16 16 16 16 16 16 16 16 3 16 16 16 16 16 16 16 16 16 16 16 16 16 16 16 3 16 16 23 18 18 18 18 18 18 18 
19 18 18 18 18 18 18 24 16 16 16 16 16 3 16 16 16 16 16 16 16 16 16 3 3 16 16 16 16 16 3 3 3 3 3 3 3 3 3 3 16 16 23 18 18 18 18 18 18 18 
18 18 18 18 18 18 18 24 16 16 16 16 16 3 16 16 16 16 16 16 16 16 16 16 3 16 16 16 16 3 3 3 3 3 3 3 3 3 16 16 16 16 23 18 18 18 18 18 18 19 
18 19 18 18 18 18 18 24 16 16 16 3 16 3 16 16 16 16 16 16 16 16 16 16 3 16 16 16 16 3 3 3 3 3 3 3 3 3 3 16 16 16 23 18 18 18 18 18 18 18 
18 18 18 18 18 18 19 24 16 16 4 5 5 5 5 5 5 5 5 5 5 6 16 16 3 16 16 16 16 16 16 3 3 3 3 3 3 3 16 16 16 16 23 18 18 18 18 18 18 18 
19 18 18 18 18 18 18 24 16 16 7 2 2 1 1 1 1 1 1 1 2 8 16 16 3 3 3 3 3 3 3 3 3 108 108 108 3 16 16 16 16 16 23 18 19 18 18 18 18 18 
18 18 18 18 18 18 18 24 16 16 7 1 2 1 2 2 2 1 1 1 1 8 16 16 3 16 16 16 16 16 16 20 21 109 110 99 21 21 21 21 21 21 31 18 18 18 18 18 18 18 
18 18 18 18 18 18 18 24 16 16 7 1 1 1 1 1 1 1 1 1 1 8 16 16 3 16 16 16 16 16 16 23 18 109 110 99 18 19 18 18 19 18 18 18 18 18 18 18 19 19 
18 18 18 18 18 18 18 24 16 16 9 10 10 10 10 10 10 10 10 10 10 11 16 16 3 16 16 16 16 16 16 23 18 109 110 99 18 18 18 18 18 18 18 18 18 18 18 18 18 18 
19 18 18 18 18 18 18 24 16 16 16 16 16 16 16 16 16 16 3 16 16 16 16 16 3 16 16 16 16 16 16 23 94 95 96 97 98 18 18 18 19 18 18 18 18 18 18 18 19 18 
18 18 18 18 18 18 19 24 16 16 16 16 16 16 16 16 16 16 3 16 16 16 16 16 3 16 16 16 16 16 16 23 19 18 182 18 18 18 18 18 18 18 18 18 18 18 18 18 19 18 
18 18 18 18 18 18 18 24 16 16 16 16 16 16 16 16 16 16 3 3 3 3 3 3 3 3 3 3 3 3 16 23 19 18 18 18 18 19 18 18 18 18 18 18 18 18 18 18 18 18 
18 18 18 18 18 18 18 24 16 16 16 16 16 16 16 16 16 16 16 16 16 16 16 16 16 16 16 16 3 16 16 25 26 26 26 26 26 26 26 26 26 26 29 19 18 18 18 18 18 19 
19 18 18 18 18 18 18 24 16 16 16 16 16 16 16 16 16 16 16 16 16 16 2 2 1 2 2 16 3 16 16 16 16 16 16 16 16 16 16 16 16 16 23 18 18 18 18 18 18 18 
18 18 18 18 18 18 19 30 21 21 21 21 21 21 21 21 21 22 16 16 1 2 1 1 1 1 2 16 3 16 16 16 16 16 16 16 16 16 16 16 16 16 23 18 18 18 18 18 18 18 
18 18 18 18 18 18 18 18 18 18 18 18 18 18 18 18 18 30 22 16 2 1 1 1 1 2 1 1 3 3 3 3 3 3 3 3 3 3 3 3 20 21 31 18 18 18 18 18 18 18 
18 18 18 18 18 18 18 18 18 18 19 19 18 18 18 18 19 19 30 21 21 21 21 21 21 21 21 21 21 21 21 21 21 21 21 21 21 21 21 21 31 19 18 18 18 18 18 18 18 18 
18 18 18 18 18 18 18 18 18 18 18 18 18 18 18 18 18 18 18 18 18 19 18 18 18 18 18 18 18 18 18 18 18 18 18 18 19 18 18 18 18 18 18 18 18 18 18 18 18 18 
19 18 18 18 18 18 18 18 18 18 18 18 18 18 18 18 18 18 18 19 18 18 18 18 18 18 18 18 18 18 18 18 18 18 18 18 18 18 18 18 18 18 18 18 18 18 18 18 18 18 
18 18 18 18 18 18 18 18 18 18 19 18 18 19 18 18 18 18 18 18 18 18 18 18 18 18 18 18 18 18 18 18 18 19 18 18 18 18 18 18 18 18 18 18 18 18 18 18 18 18 
19 19 19 18 18 18 18 18 18 18 18 18 18 18 18 18 18 18 18 18 18 18 18 18 18 18 18 18 18 19 19 18 18 19 18 18 18 18 18 18 18 18 18 18 18 18 18 18 18 18 
