122 122 122 122 122 122 122 122 122 122 122 122 122 122 122 122 122 122 122 143 120 120 121 140 122 122 122 122 122 122 122 122 122 122 122 122 122 122 122 122 122 122 122 122 122 122 122 122 122 122 
122 122 122 122 122 122 122 122 122 122 122 122 122 122 122 122 122 122 122 143 120 121 120 140 122 122 122 122 122 122 122 122 122 122 122 122 122 122 122 122 122 122 122 122 122 122 122 122 122 122 
122 122 122 122 122 122 122 122 122 122 122 122 122 122 122 122 122 122 122 143 120 121 120 140 122 122 122 122 122 122 122 122 122 122 122 122 122 122 122 122 122 122 122 122 122 122 122 122 122 122 
122 122 122 122 122 122 122 122 122 122 122 122 122 122 122 122 122 122 122 143 172 172 172 140 122 122 122 122 122 122 122 122 122 122 122 122 122 122 122 122 122 122 122 122 122 122 122 122 122 122 
122 122 122 122 122 122 122 136 139 139 135 122 122 122 122 122 122 136 139 137 120 120 120 138 139 139 139 139 139 139 135 122 122 122 122 122 122 122 122 122 122 122 122 122 122 122 122 122 122 122 
122 122 122 122 122 122 136 137 121 121 138 122 122 122 136 139 139 137 120 121 120 121 121 172 157 157 157 172 172 157 138 139 139 135 136 139 139 139 139 139 139 135 122 122 122 122 122 122 122 122 
122 122 122 122 122 122 143 120 121 120 121 138 139 139 137 121 121 121 121 153 151 151 154 157 157 157 157 157 172 157 157 157 157 138 137 120 120 121 121 120 120 140 122 122 122 122 122 122 122 122 
122 122 122 122 122 136 137 121 121 121 121 121 121 120 121 121 121 121 157 150 3 3 149 157 172 157 157 157 157 157 157 157 157 157 157 157 121 121 121 121 120 138 135 122 122 122 122 122 122 122 
122 122 122 122 122 143 121 121 157 121 120 121 121 120 121 120 157 121 121 150 3 145 156 157 157 172 172 157 157 157 157 157 157 157 157 157 157 153 151 154 157 157 140 122 122 122 122 122 122 122 
122 122 122 122 136 137 121 121 157 121 121 157 157 121 157 120 157 157 121 150 3 149 157 157 157 157 157 157 172 157 157 172 157 172 157 157 157 150 3 149 157 172 140 122 122 122 122 122 122 122 
122 122 122 122 143 121 157 157 121 121 121 121 157 121 157 121 121 157 121 150 3 146 154 157 157 157 157 172 172 172 172 157 157 157 172 172 157 150 3 146 154 172 140 122 122 122 122 122 122 122 
122 122 122 122 143 121 121 121 121 121 157 121 121 121 172 121 121 121 121 150 3 3 146 151 151 151 151 151 151 151 154 157 157 157 157 172 157 150 3 3 149 172 140 122 122 122 122 122 122 122 
122 122 122 122 143 120 121 157 157 121 120 157 121 120 172 172 157 121 121 155 148 3 3 3 3 3 3 3 3 3 149 157 157 172 157 172 157 157 148 3 149 172 140 122 122 122 122 122 122 122 
122 122 122 122 143 121 121 121 157 121 121 121 121 121 157 157 157 157 157 157 155 147 147 147 147 147 147 147 148 3 149 157 157 172 157 157 157 157 150 3 149 157 138 135 122 122 122 122 122 122 
122 122 122 122 134 141 120 121 121 121 121 120 157 121 121 157 157 157 157 172 157 157 157 157 157 157 157 157 150 3 149 157 157 157 157 157 157 153 152 3 149 172 120 140 122 122 122 122 122 122 
122 122 122 122 122 134 141 120 121 157 157 157 121 120 157 157 157 157 157 157 157 157 157 157 157 172 172 157 150 3 149 157 172 172 157 157 153 152 3 145 156 157 120 140 122 122 122 122 122 122 
122 122 122 122 122 122 143 120 120 121 121 121 121 153 151 151 151 151 151 151 151 154 157 157 172 172 157 157 150 3 146 151 157 157 157 157 152 3 3 149 157 172 121 140 122 122 122 122 122 122 
122 122 122 122 122 122 134 141 120 121 121 120 121 150 3 3 3 3 3 3 3 146 157 157 157 157 157 157 150 3 3 3 149 157 157 150 3 3 145 156 157 157 157 140 122 122 122 122 122 122 
122 122 122 122 122 122 122 143 120 120 121 120 120 155 147 147 147 147 147 148 3 3 146 157 157 157 157 157 155 148 3 3 146 151 151 152 3 145 156 157 157 120 121 140 122 122 122 122 122 122 
122 122 122 122 122 122 122 134 142 142 142 142 142 109 110 111 142 141 121 155 148 3 3 146 151 151 151 151 151 152 3 3 3 3 3 3 3 149 121 157 121 121 121 140 122 122 122 122 122 122 
122 122 122 122 122 122 122 122 122 122 122 122 122 109 110 111 122 143 121 157 155 148 3 3 3 3 3 3 3 3 3 145 147 147 147 147 147 156 157 157 121 120 120 140 122 122 122 122 122 122 
122 122 122 122 122 122 122 122 122 122 122 122 160 162 158 159 161 143 120 121 121 155 147 147 147 147 147 147 147 147 147 156 120 157 157 157 120 121 121 120 120 120 120 140 122 122 122 122 122 122 
122 122 122 122 122 122 122 122 122 122 122 122 122 122 122 122 122 143 120 120 120 120 157 157 157 157 121 157 157 125 121 121 125 120 157 157 157 121 121 120 120 121 120 140 122 122 122 122 122 122 
122 122 122 122 122 122 122 122 122 122 122 122 122 122 122 136 139 137 121 121 157 121 121 120 120 120 120 120 120 126 120 120 125 120 120 120 120 120 157 120 121 157 121 140 122 122 122 122 122 122 
122 122 122 122 122 122 122 136 139 139 139 139 139 139 139 137 126 127 124 126 120 120 123 128 123 124 120 128 123 128 120 120 123 128 128 120 123 124 125 121 121 120 121 140 122 122 122 122 122 122 
122 122 122 122 122 122 122 143 121 120 121 120 120 121 120 120 127 120 121 121 121 121 172 120 120 120 120 120 120 121 121 121 121 121 120 120 120 120 126 121 120 157 121 140 122 122 122 122 122 122 
122 122 122 122 122 122 136 137 121 121 121 121 120 121 127 123 124 120 120 129 130 120 172 120 121 121 163 164 165 121 121 172 120 121 121 121 121 120 120 121 121 157 120 140 122 122 122 122 122 122 
122 122 122 122 122 122 143 121 121 121 172 121 120 126 120 121 120 120 120 131 132 121 153 154 121 121 169 170 171 120 121 121 120 121 120 121 120 121 125 121 121 120 121 140 122 122 122 122 122 122 
122 122 122 122 122 122 143 121 157 121 121 121 121 125 121 121 121 121 153 151 151 151 152 146 151 154 166 167 168 121 121 121 121 120 120 121 121 120 126 120 121 121 121 140 122 122 122 122 122 122 
122 122 122 122 122 122 143 121 172 157 120 121 121 126 121 120 121 121 155 147 147 147 148 145 148 146 151 151 151 151 151 151 151 154 121 121 121 120 125 125 121 121 120 140 122 122 122 122 122 122 
122 122 122 122 122 122 143 121 121 121 121 121 121 125 121 121 121 121 121 120 157 121 150 149 155 147 147 147 147 148 145 147 147 156 121 120 121 121 126 120 120 121 120 140 122 122 122 122 122 122 
122 122 122 122 122 122 134 141 120 157 157 120 121 126 120 153 151 151 151 151 151 151 152 149 121 121 121 120 121 150 149 157 120 116 115 114 120 121 121 121 120 120 172 140 122 122 122 122 122 122 
122 122 122 122 122 122 122 143 120 157 121 121 121 127 120 155 147 147 147 147 147 147 148 149 120 116 115 114 120 150 149 121 120 118 119 117 120 121 121 121 121 121 120 138 135 122 122 122 122 122 
122 122 122 122 122 122 122 143 120 157 121 121 121 121 121 121 120 116 115 114 121 120 150 149 120 118 119 117 120 150 146 151 151 151 151 154 121 120 127 120 121 121 121 121 140 122 122 122 122 122 
122 122 122 122 122 122 122 143 120 172 120 121 120 123 124 120 121 118 119 117 121 121 150 146 151 151 151 154 121 155 147 147 147 147 147 156 120 120 120 121 121 120 120 121 140 122 122 122 122 122 
122 122 122 122 122 122 122 143 121 121 120 120 157 120 120 126 121 153 151 151 151 151 152 145 147 147 147 156 121 172 121 120 120 127 120 127 123 124 120 121 157 157 157 120 140 122 122 122 122 122 
122 122 122 122 122 122 122 143 121 121 121 121 172 120 120 125 121 155 147 147 147 147 147 156 120 120 121 120 120 120 120 120 120 125 121 121 121 121 121 120 157 120 120 144 133 122 122 122 122 122 
122 122 122 122 122 122 122 143 120 121 157 121 172 157 120 126 120 127 124 120 127 120 123 124 120 120 121 120 127 124 120 123 124 126 120 120 120 120 121 157 157 120 120 140 122 122 122 122 122 122 
122 122 122 122 122 122 122 143 120 121 157 121 120 157 120 121 121 121 121 121 121 120 121 120 126 121 121 127 120 120 121 120 121 121 120 120 157 120 120 172 120 121 144 133 122 122 122 122 122 122 
122 122 122 122 122 122 122 143 121 121 120 121 120 120 120 121 120 120 120 120 121 120 120 120 127 120 121 120 120 121 120 120 121 121 121 121 121 121 120 172 121 121 140 122 122 122 122 122 122 122 
122 122 122 122 122 122 122 143 120 121 121 121 121 121 121 121 121 121 121 121 121 157 120 120 126 120 121 127 120 121 120 120 157 172 157 157 121 121 120 120 120 144 133 122 122 122 122 122 122 122 
122 122 122 122 122 122 122 134 141 120 121 172 121 120 120 120 172 172 157 120 120 120 120 120 120 120 121 120 120 121 121 121 120 120 120 120 121 120 144 142 142 133 122 122 122 122 122 122 122 122 
122 122 122 122 122 122 122 122 134 141 120 120 120 157 157 120 120 120 121 121 121 120 120 157 121 121 121 121 121 144 142 142 142 142 142 142 142 142 133 122 122 122 122 122 122 122 122 122 122 122 
122 122 122 122 122 122 122 122 122 134 142 141 157 157 120 121 121 121 121 121 121 120 120 120 121 121 121 120 144 133 122 122 122 122 122 122 122 122 122 122 122 122 122 122 122 122 122 122 122 122 
122 122 122 122 122 122 122 122 122 122 122 134 142 142 142 142 142 142 142 142 142 142 142 141 121 121 121 144 133 122 122 122 122 122 122 122 122 122 122 122 122 122 122 122 122 122 122 122 122 122 
122 122 122 122 122 122 122 122 122 122 122 122 122 122 122 122 122 122 122 122 122 122 122 134 142 142 142 133 122 122 122 122 122 122 122 122 122 122 122 122 122 122 122 122 122 122 122 122 122 122 
122 122 122 122 122 122 122 122 122 122 122 122 122 122 122 122 122 122 122 122 122 122 122 122 122 122 122 122 122 122 122 122 122 122 122 122 122 122 122 122 122 122 122 122 122 122 122 122 122 122 
122 122 122 122 122 122 122 122 122 122 122 122 122 122 122 122 122 122 122 122 122 122 122 122 122 122 122 122 122 122 122 122 122 122 122 122 122 122 122 122 122 122 122 122 122 122 122 122 122 122 
122 122 122 122 122 122 122 122 122 122 122 122 122 122 122 122 122 122 122 122 122 122 122 122 122 122 122 122 122 122 122 122 122 122 122 122 122 122 122 122 122 122 122 122 122 122 122 122 122 122 
122 122 122 122 122 122 122 122 122 122 122 122 122 122 122 122 122 122 122 122 122 122 122 122 122 122 122 122 122 122 122 122 122 122 122 122 122 122 122 122 122 122 122 122 122 122 122 122 122 122 
