224 224 224 224 224 224 224 224 224 224 224 224 224 224 224 224 224 224 224 224 224 224 224 224 224 224 224 224 224 224 224 224 224 224 224 224 224 224 224 224 224 224 224 224 224 224 224 224 224 224 
224 224 224 224 224 224 224 224 224 224 224 224 224 224 224 224 224 225 224 224 224 224 224 224 224 224 224 224 224 224 224 224 224 224 224 224 224 224 224 224 224 224 224 224 224 224 224 224 224 224 
224 224 224 224 224 224 224 224 224 224 224 224 224 224 224 224 224 225 225 224 224 224 224 224 224 224 224 224 225 224 224 224 224 224 224 224 224 224 224 224 224 224 224 224 224 224 224 224 224 224 
224 224 224 224 224 224 224 224 224 224 224 224 224 224 224 224 224 224 224 225 225 225 225 224 224 224 224 224 225 224 224 224 224 224 224 224 224 224 224 224 224 224 224 224 224 224 224 224 224 224 
224 224 224 224 224 224 224 224 224 224 224 224 224 224 224 224 224 224 224 224 224 224 224 225 225 225 224 224 225 224 224 224 224 224 224 224 224 224 224 224 224 224 224 224 224 224 224 224 224 224 
224 224 224 224 224 224 224 224 224 224 224 224 224 224 224 224 224 224 224 224 224 224 224 224 224 225 225 224 225 224 224 224 224 224 224 224 224 224 224 224 224 224 224 224 224 224 224 224 224 224 
224 224 224 224 224 224 224 224 224 224 224 224 224 224 224 224 224 224 224 224 224 224 224 224 224 224 224 224 224 224 224 224 224 225 225 225 225 225 225 225 224 224 224 224 224 224 224 224 224 224 
224 224 224 224 224 224 224 224 224 224 224 224 224 224 225 225 225 225 225 225 225 225 225 224 224 224 224 224 224 224 224 224 224 224 224 224 224 224 224 224 224 224 224 224 224 224 224 224 224 224 
224 224 224 224 224 224 224 224 224 224 224 224 224 224 224 224 224 224 224 224 224 224 225 224 224 224 224 224 224 224 224 224 224 225 225 224 224 224 224 224 224 224 224 224 224 224 224 224 224 224 
224 224 224 224 224 224 224 224 224 224 224 224 224 224 224 224 224 224 225 225 225 225 225 224 224 224 224 224 224 224 224 224 224 224 225 224 224 224 224 224 225 225 224 224 225 224 224 224 224 224 
224 224 224 224 224 224 224 224 224 224 224 224 224 224 224 224 225 225 225 224 224 224 224 224 229 232 232 232 232 232 232 232 232 232 232 232 232 228 224 224 225 224 224 224 225 225 225 224 224 224 
224 224 224 224 224 224 224 224 224 224 224 224 224 224 224 224 224 224 224 224 224 229 232 232 230 238 238 238 238 238 238 238 238 238 238 238 238 233 224 224 225 225 224 224 224 224 225 225 224 224 
224 224 224 224 224 224 224 224 224 224 224 224 224 224 224 224 224 224 224 224 224 236 238 238 238 238 238 215 215 215 215 215 238 238 238 238 238 233 224 224 224 224 224 224 224 224 224 224 224 224 
224 224 224 224 224 224 224 224 224 224 224 224 224 224 224 224 224 229 232 232 232 230 238 238 238 238 215 215 215 215 215 215 238 238 238 238 238 233 224 224 224 224 224 224 224 224 224 224 224 224 
224 224 224 224 224 224 224 224 224 224 224 224 224 224 224 224 224 236 238 238 238 238 238 238 215 215 215 215 215 213 215 215 215 215 215 215 238 233 224 224 224 224 224 224 224 225 225 225 225 224 
224 224 224 224 225 224 224 224 224 224 224 229 232 232 232 232 232 230 238 238 238 238 238 213 213 213 213 213 213 213 213 213 215 213 213 215 238 231 228 224 225 225 225 225 225 225 225 225 225 224 
224 224 224 224 225 224 224 224 224 224 229 230 238 238 238 238 238 238 238 238 238 213 213 213 213 213 213 213 213 213 213 213 213 213 213 215 238 238 233 224 224 224 224 224 224 224 224 224 224 224 
224 224 224 224 225 224 224 224 224 224 236 238 238 215 215 215 215 212 212 212 212 212 212 212 212 212 212 213 213 213 213 213 213 213 213 213 213 238 233 224 224 224 224 224 224 224 224 224 224 224 
224 224 224 224 225 224 224 224 224 224 227 234 238 215 215 215 215 212 212 212 212 212 212 212 212 212 212 213 213 213 213 213 213 213 213 213 213 238 233 224 224 224 224 224 224 224 224 224 224 224 
224 224 224 224 225 224 224 225 225 224 224 236 238 215 215 215 215 212 212 212 212 212 212 212 212 212 212 213 213 213 213 213 213 213 213 213 238 238 233 224 224 224 224 224 224 224 224 224 224 224 
224 224 224 224 225 224 224 224 225 224 224 236 238 215 215 215 215 212 212 212 212 212 212 212 212 212 212 213 213 213 215 213 213 213 213 213 238 237 226 224 224 224 224 224 224 224 224 224 224 224 
224 224 224 224 225 224 224 224 225 225 224 236 238 215 215 215 215 212 212 212 212 212 212 212 212 212 212 213 213 213 215 215 213 213 213 213 238 233 224 224 224 224 224 224 224 224 224 224 224 224 
224 224 224 224 224 224 224 224 224 225 224 236 238 215 215 215 215 212 212 212 212 212 212 212 212 212 212 213 213 215 213 213 213 215 215 215 238 233 224 224 224 224 224 224 224 224 224 224 224 224 
224 224 224 224 224 224 224 224 224 224 224 236 238 215 215 215 215 212 212 212 212 212 212 212 212 212 212 213 213 215 213 215 213 215 215 215 238 233 224 224 224 224 224 224 224 224 224 224 224 224 
224 224 224 224 224 224 224 224 224 224 224 236 238 215 215 215 215 212 212 212 212 212 212 212 212 212 212 213 213 215 213 215 213 215 215 215 238 233 224 224 224 224 224 224 224 224 224 224 224 224 
224 224 224 224 224 224 224 224 224 224 224 236 238 215 215 215 215 215 213 213 213 213 213 213 213 213 213 213 213 215 213 213 213 215 215 238 238 233 224 224 224 224 224 224 225 225 225 224 224 224 
224 224 224 224 224 224 224 224 224 224 229 230 238 215 215 215 215 215 215 213 213 213 213 213 213 213 213 213 213 215 215 213 213 215 215 238 237 224 224 224 224 224 224 225 225 224 225 225 224 224 
224 224 224 224 224 224 224 224 224 224 236 238 238 215 215 215 215 215 215 213 213 213 213 213 213 213 213 213 213 213 213 213 213 215 215 238 231 228 224 224 224 224 225 225 224 224 224 224 224 224 
224 224 224 224 224 224 224 224 224 224 236 238 215 215 215 215 215 215 215 215 215 215 215 215 215 215 215 215 215 215 213 213 215 215 215 215 238 233 224 224 224 224 224 224 224 224 224 224 224 224 
224 224 224 224 224 224 224 224 224 224 236 238 215 215 215 215 215 215 215 215 215 215 215 215 215 215 215 215 215 213 213 213 215 215 238 238 238 233 224 224 224 224 224 224 224 224 224 224 224 224 
224 224 224 224 225 224 224 224 224 224 236 238 238 238 238 215 215 215 215 215 215 215 215 215 215 215 215 213 213 213 213 213 215 215 238 237 235 226 224 224 224 224 224 224 224 224 224 224 224 224 
224 224 224 225 225 224 224 224 224 224 227 235 235 234 238 215 215 215 215 238 238 215 238 238 215 215 213 213 213 213 213 215 215 238 238 233 224 224 224 224 224 224 224 224 224 224 224 224 224 224 
224 224 225 225 224 224 224 224 224 224 224 224 224 236 238 215 215 215 215 238 214 214 214 238 215 215 215 213 213 213 213 215 215 238 237 226 224 224 224 224 224 224 224 224 224 224 224 224 224 224 
224 224 225 224 224 224 224 225 224 224 224 224 224 236 238 238 215 215 215 238 214 214 214 238 215 215 213 213 213 213 215 215 238 238 224 224 224 224 224 224 224 224 224 224 224 224 224 224 224 224 
224 224 225 224 224 224 224 225 225 224 224 224 224 227 234 238 215 215 215 238 214 214 214 238 215 215 213 213 213 213 215 215 238 237 224 224 224 224 224 224 225 225 225 225 225 225 224 225 224 224 
224 224 224 224 224 224 224 224 225 225 224 225 224 224 236 238 215 215 215 238 214 214 214 238 215 213 213 215 215 215 215 238 238 233 224 224 224 224 224 224 225 224 224 224 224 224 224 225 224 224 
224 224 224 224 224 224 224 224 224 224 224 225 224 224 236 238 215 215 215 238 214 214 214 238 213 213 238 238 238 238 238 238 238 233 224 224 224 224 224 224 225 224 224 224 224 224 224 225 224 224 
224 224 224 224 224 224 224 224 224 224 224 225 224 224 236 238 238 238 238 238 214 214 214 238 238 238 238 237 235 235 235 235 235 226 224 224 224 224 224 224 224 224 224 224 224 224 224 224 224 224 
224 224 224 224 224 224 224 224 224 224 224 225 225 224 227 235 235 235 235 235 221 222 223 235 235 235 235 226 224 224 224 224 224 224 224 224 224 224 224 224 224 225 224 224 224 224 224 224 224 224 
224 224 224 224 224 224 224 224 224 224 224 224 225 224 224 224 224 224 224 224 221 222 223 224 224 224 224 224 225 225 225 224 224 224 224 224 224 224 224 224 225 224 224 224 224 224 224 224 224 224 
224 224 224 224 224 224 224 224 224 224 224 224 224 224 224 224 224 224 224 225 221 222 223 225 225 225 224 224 224 224 225 224 224 224 224 224 224 224 224 225 225 224 224 224 224 224 224 224 224 224 
224 224 224 224 224 224 224 224 224 224 224 224 224 224 225 225 224 224 225 216 217 218 219 220 224 225 225 225 224 224 224 224 224 224 224 224 224 224 224 224 225 225 224 224 224 224 224 224 224 224 
224 224 224 224 224 224 224 224 224 224 224 224 224 224 224 225 225 224 224 225 225 241 225 225 225 224 224 225 225 224 224 224 224 224 224 224 224 224 224 224 224 224 224 224 224 224 224 224 224 224 
224 224 224 224 224 224 224 224 224 224 224 224 224 225 224 224 224 224 224 224 224 225 225 225 225 224 224 224 225 224 224 224 224 224 224 224 224 224 224 224 224 224 224 224 224 224 224 224 224 224 
224 224 224 224 224 224 224 224 224 224 224 224 224 225 225 225 224 224 224 224 224 224 224 224 224 225 225 225 225 225 224 224 224 224 224 224 224 224 224 224 224 224 224 224 224 224 224 224 224 224 
224 224 224 224 224 224 224 224 224 224 224 224 224 224 224 225 225 224 224 224 224 225 225 225 225 225 225 224 224 225 224 224 224 224 224 224 224 224 224 224 224 224 224 224 224 224 224 224 224 224 
224 224 224 224 224 224 224 224 224 224 224 224 224 224 224 224 225 225 225 225 225 225 224 224 224 224 224 224 224 224 224 224 224 224 224 224 224 224 224 224 224 224 224 224 224 224 224 224 224 224 
224 224 224 224 224 224 224 224 224 224 224 224 224 224 224 224 224 224 224 225 224 224 224 224 224 224 224 224 224 224 224 224 224 224 224 224 224 224 224 224 224 224 224 224 224 224 224 224 224 224 
224 224 224 224 224 224 224 224 224 224 224 224 224 224 224 224 224 224 224 224 224 224 224 224 224 224 224 224 224 224 224 224 224 224 224 224 224 224 224 224 224 224 224 224 224 224 224 224 224 224 
224 224 224 224 224 224 224 224 224 224 224 224 224 224 224 224 224 224 224 224 224 224 224 224 224 224 224 224 224 224 224 224 224 224 224 224 224 224 224 224 224 224 224 224 224 224 224 224 224 224 
