0 0 0 0 0 0 0 0 0 0 0 0 0 0 0 0 0 0 0 0 0 0 0 0 0 0 0 0 0 0 0 0 0 0 0 0 0 0 0 0 0 0 0 0 0 0 0 0 0 0 
0 0 0 0 0 0 0 0 0 0 0 0 0 0 0 0 0 0 0 0 0 0 0 0 0 0 0 0 0 0 0 0 0 0 0 0 0 0 0 0 0 0 0 0 0 0 0 0 0 0 
0 0 0 0 0 0 0 0 0 0 0 0 0 0 0 0 0 0 0 0 0 0 0 0 0 0 0 0 0 0 0 0 0 0 0 0 0 0 0 0 0 0 0 0 0 0 0 0 0 0 
0 0 0 0 0 0 0 0 0 0 0 0 0 0 0 196 199 199 199 199 199 199 199 195 0 0 0 0 0 0 0 0 196 199 199 199 195 0 0 0 0 0 0 0 0 0 0 0 0 0 
0 0 0 0 0 0 0 0 0 0 0 196 199 199 199 197 157 157 157 172 157 157 157 198 195 0 0 0 196 199 199 199 197 157 157 172 198 199 195 0 0 0 0 0 0 0 0 0 0 0 
0 0 0 0 0 0 0 0 0 0 196 197 157 157 157 157 157 157 157 172 172 172 157 157 198 199 199 199 197 157 157 157 157 172 172 172 157 157 198 195 0 0 0 0 0 0 0 0 0 0 
0 0 0 0 0 0 0 0 0 196 197 157 172 172 172 172 157 121 121 121 172 172 157 157 157 157 157 157 172 172 172 157 121 187 121 157 172 172 157 198 195 0 0 0 0 0 0 0 0 0 
0 0 0 0 0 0 0 0 196 197 157 172 172 121 121 121 121 121 121 121 172 172 172 157 157 172 172 157 121 121 121 121 121 121 121 121 121 157 157 157 198 199 195 0 0 0 0 0 0 0 
0 0 0 0 0 0 0 196 197 172 157 121 121 121 121 121 121 121 121 187 121 157 172 157 157 121 121 121 121 121 121 184 121 121 121 186 121 121 121 157 157 157 200 0 0 0 0 0 0 0 
0 0 0 0 0 0 0 203 157 172 121 121 121 121 121 121 121 121 121 121 121 157 157 157 121 121 121 121 121 172 157 157 121 121 121 121 121 121 121 172 172 157 198 199 199 195 0 0 0 0 
0 0 0 0 0 0 0 203 172 172 121 121 121 184 121 121 121 121 121 121 121 157 157 172 121 121 121 121 121 172 172 157 157 157 121 121 121 121 121 121 121 172 172 157 157 200 0 0 0 0 
0 0 0 0 0 0 196 197 157 157 121 121 121 121 121 121 121 121 121 121 121 172 157 157 121 121 121 121 121 157 172 172 157 157 157 157 157 157 121 121 121 121 172 157 157 200 0 0 0 0 
0 0 0 0 0 0 203 157 157 121 121 121 121 121 121 121 121 121 121 121 186 172 172 121 121 121 157 121 121 121 157 172 157 157 157 172 172 157 157 121 121 121 172 172 157 200 0 0 0 0 
0 0 0 0 0 196 197 157 157 121 121 121 121 121 121 121 121 121 121 121 121 121 172 121 121 121 157 157 121 121 157 157 157 157 157 157 172 172 157 121 121 121 121 172 157 200 0 0 0 0 
0 0 0 0 196 197 157 172 172 121 121 121 121 121 121 121 121 121 121 121 121 121 172 121 121 157 157 172 121 121 121 157 157 172 157 157 157 172 172 121 121 121 121 157 157 200 0 0 0 0 
0 0 0 0 203 157 172 157 121 121 121 121 121 121 121 121 121 121 121 121 121 121 121 121 121 157 172 157 121 121 121 121 121 157 157 172 157 172 172 121 121 121 121 157 157 200 0 0 0 0 
0 0 0 0 203 157 157 157 121 121 183 121 121 121 121 121 121 121 121 121 121 121 121 121 121 157 157 157 157 121 121 121 121 121 121 121 157 157 121 121 121 121 157 157 172 200 0 0 0 0 
0 0 0 0 203 172 157 157 121 121 121 121 121 121 121 121 121 185 121 121 121 121 121 121 157 157 157 157 157 121 121 121 121 121 121 121 121 121 121 121 121 121 157 157 172 200 0 0 0 0 
0 0 0 0 203 172 172 157 121 121 121 121 121 121 121 121 121 121 121 121 121 172 172 172 172 157 157 157 157 157 121 121 121 121 121 121 121 121 121 121 121 121 172 157 157 200 0 0 0 0 
0 0 0 0 203 157 157 157 157 157 157 157 157 157 157 157 157 157 172 172 157 172 157 157 157 157 157 157 157 157 157 157 157 172 121 121 121 121 121 121 121 157 172 157 204 205 0 0 0 0 
0 0 0 0 194 201 157 172 157 157 157 157 157 157 157 157 157 157 157 172 157 172 157 157 157 157 172 172 157 157 157 157 157 172 121 121 121 121 121 121 121 172 172 157 200 0 0 0 0 0 
0 0 0 0 0 203 157 172 157 157 157 157 157 157 157 157 157 157 157 157 157 157 157 157 157 157 157 157 172 157 157 157 172 172 121 121 121 121 121 121 157 157 157 157 200 0 0 0 0 0 
0 0 0 0 0 203 157 172 172 157 157 157 157 157 121 121 121 121 121 121 121 121 121 121 121 121 121 121 121 157 157 172 172 157 121 121 121 121 121 121 157 157 157 157 200 0 0 0 0 0 
0 0 0 0 0 203 157 157 172 121 183 121 121 186 121 121 184 121 121 183 121 121 185 121 121 121 187 121 121 157 172 172 157 157 121 121 121 121 121 121 157 172 157 157 200 0 0 0 0 0 
0 0 0 0 0 194 201 157 157 121 121 121 121 121 121 121 121 121 121 121 121 121 121 121 121 121 121 121 121 121 157 157 157 157 121 121 121 121 121 121 172 172 157 157 200 0 0 0 0 0 
0 0 0 0 0 196 197 157 157 121 121 121 121 121 121 121 121 121 121 121 121 121 121 172 157 121 121 121 121 121 157 157 157 157 121 121 121 121 121 172 172 157 157 157 198 195 0 0 0 0 
0 0 0 0 0 203 157 157 157 121 185 121 121 187 121 121 185 121 121 121 121 157 157 157 172 172 121 121 121 121 121 157 157 157 121 121 121 121 157 172 157 157 157 157 172 200 0 0 0 0 
0 0 0 0 0 203 172 157 157 172 172 172 121 121 121 121 121 121 121 121 157 157 157 157 157 157 121 121 121 121 121 157 172 157 121 121 121 121 172 157 157 157 157 157 172 200 0 0 0 0 
0 0 0 0 0 203 172 157 157 157 157 172 172 157 157 121 121 121 121 172 157 157 157 157 157 157 121 121 121 121 121 172 172 157 121 121 121 157 172 121 121 121 121 157 172 200 0 0 0 0 
0 0 0 0 0 203 157 172 172 157 157 157 157 172 172 121 121 121 121 172 157 157 172 157 157 157 121 121 121 121 121 157 157 157 121 121 121 157 157 121 185 121 157 172 172 200 0 0 0 0 
0 0 0 0 0 203 157 157 157 157 157 157 157 172 157 121 121 121 121 172 157 172 172 157 157 157 121 121 121 121 121 157 157 157 121 121 121 157 172 121 121 121 157 157 157 200 0 0 0 0 
0 0 0 0 0 194 201 157 157 157 157 157 172 172 157 121 121 121 121 157 157 157 172 172 157 157 121 121 121 121 157 157 157 121 121 121 121 157 172 121 121 121 157 157 157 200 0 0 0 0 
0 0 0 0 0 0 194 201 157 157 157 172 172 157 121 121 121 121 121 121 157 157 157 157 121 121 121 121 121 157 157 157 157 121 121 121 157 157 157 121 121 121 157 157 157 200 0 0 0 0 
0 0 0 0 0 0 0 203 157 157 172 157 121 121 121 121 121 121 121 121 121 157 172 157 121 121 121 121 157 172 172 157 121 121 121 157 172 157 121 121 172 172 157 157 204 205 0 0 0 0 
0 0 0 0 0 0 196 197 157 172 172 157 121 121 121 121 121 121 121 121 121 172 172 121 121 121 121 121 157 172 172 157 121 121 121 157 157 121 121 121 157 157 157 204 205 0 0 0 0 0 
0 0 0 0 0 0 203 157 157 172 172 157 121 121 121 121 121 121 121 121 121 121 121 121 121 121 121 157 172 172 157 157 121 121 121 121 121 121 121 157 172 157 157 200 0 0 0 0 0 0 
0 0 0 0 0 0 203 157 157 157 157 157 157 157 121 121 121 121 121 121 121 121 121 121 121 121 121 172 172 157 121 121 121 121 121 121 121 172 157 172 172 157 157 200 0 0 0 0 0 0 
0 0 0 0 0 0 194 202 202 201 157 157 172 172 172 157 157 157 121 121 121 121 121 121 121 121 121 121 121 121 121 121 121 121 121 121 157 172 157 157 157 157 204 205 0 0 0 0 0 0 
0 0 0 0 0 0 0 0 0 194 202 202 201 157 172 172 172 172 157 157 157 157 157 121 121 121 121 121 121 121 121 121 121 121 172 172 172 172 157 157 157 157 200 0 0 0 0 0 0 0 
0 0 0 0 0 0 0 0 0 0 0 0 203 157 157 157 157 157 172 172 157 157 157 157 157 157 157 157 157 157 121 121 121 157 172 172 157 157 157 157 157 204 205 0 0 0 0 0 0 0 
0 0 0 0 0 0 0 0 0 0 0 0 194 202 202 202 202 201 157 172 172 172 172 172 172 172 172 172 157 157 121 37 121 157 172 157 157 157 157 204 202 205 0 0 0 0 0 0 0 0 
0 0 0 0 0 0 0 0 0 0 0 0 0 0 0 0 0 194 202 202 202 202 202 202 202 202 202 202 201 157 157 157 157 157 204 202 202 202 202 205 0 0 0 0 0 0 0 0 0 0 
0 0 0 0 0 0 0 0 0 0 0 0 0 0 0 0 0 0 0 0 0 0 0 0 0 0 0 0 194 202 202 202 202 202 205 0 0 0 0 0 0 0 0 0 0 0 0 0 0 0 
0 0 0 0 0 0 0 0 0 0 0 0 0 0 0 0 0 0 0 0 0 0 0 0 0 0 0 0 0 0 0 0 0 0 0 0 0 0 0 0 0 0 0 0 0 0 0 0 0 0 
0 0 0 0 0 0 0 0 0 0 0 0 0 0 0 0 0 0 0 0 0 0 0 0 0 0 0 0 0 0 0 0 0 0 0 0 0 0 0 0 0 0 0 0 0 0 0 0 0 0 
0 0 0 0 0 0 0 0 0 0 0 0 0 0 0 0 0 0 0 0 0 0 0 0 0 0 0 0 0 0 0 0 0 0 0 0 0 0 0 0 0 0 0 0 0 0 0 0 0 0 
0 0 0 0 0 0 0 0 0 0 0 0 0 0 0 0 0 0 0 0 0 0 0 0 0 0 0 0 0 0 0 0 0 0 0 0 0 0 0 0 0 0 0 0 0 0 0 0 0 0 
0 0 0 0 0 0 0 0 0 0 0 0 0 0 0 0 0 0 0 0 0 0 0 0 0 0 0 0 0 0 0 0 0 0 0 0 0 0 0 0 0 0 0 0 0 0 0 0 0 0 
0 0 0 0 0 0 0 0 0 0 0 0 0 0 0 0 0 0 0 0 0 0 0 0 0 0 0 0 0 0 0 0 0 0 0 0 0 0 0 0 0 0 0 0 0 0 0 0 0 0 
0 0 0 0 0 0 0 0 0 0 0 0 0 0 0 0 0 0 0 0 0 0 0 0 0 0 0 0 0 0 0 0 0 0 0 0 0 0 0 0 0 0 0 0 0 0 0 0 0 0 
