0 0 0 0 0 0 0 0 0 0 0 0 0 0 0 0 0 0 0 0 0 0 0 0 0 0 0 0 0 0 0 0 0 0 0 0 0 0 0 0 0 0 0 0 0 0 0 0 0 0 
0 0 0 0 0 0 0 0 0 0 0 0 0 0 0 0 0 0 0 0 0 0 0 0 0 0 0 0 0 0 0 0 0 0 0 0 0 0 0 0 0 0 0 0 0 0 0 0 0 0 
0 0 0 0 0 0 0 0 0 0 0 0 0 0 0 0 0 0 0 0 0 0 0 0 0 0 0 0 0 0 0 0 0 0 0 0 0 0 0 0 0 0 0 0 0 0 0 0 0 0 
0 0 0 0 0 0 0 0 0 0 0 0 0 0 0 0 0 0 0 0 0 0 0 0 0 0 0 0 0 0 0 0 0 0 0 0 0 0 0 0 0 0 0 0 0 0 0 0 0 0 
0 0 0 0 0 56 59 59 55 0 0 0 0 0 0 56 59 59 59 59 59 59 59 59 59 59 59 55 0 0 0 0 0 0 0 0 0 0 0 0 0 0 0 0 0 0 0 0 0 0 
0 0 0 0 56 57 52 52 58 59 59 59 59 59 55 63 52 52 52 52 52 52 52 52 52 52 52 58 55 0 0 0 0 0 56 59 55 0 0 0 0 0 0 0 56 59 55 0 0 0 
0 0 0 0 63 52 68 68 52 52 52 52 52 52 58 57 79 79 79 79 79 68 68 68 68 68 52 52 58 55 56 59 59 59 57 52 58 59 55 0 0 0 0 56 57 52 58 55 0 0 
0 0 0 0 63 52 68 68 68 68 68 68 68 52 52 52 68 65 65 79 79 68 68 68 68 68 68 52 52 58 57 52 52 52 52 79 52 52 58 55 0 0 56 57 52 52 52 60 0 0 
0 0 0 0 63 52 68 68 68 68 68 68 68 68 68 68 68 65 65 79 79 79 79 68 68 68 68 68 52 52 52 68 68 68 79 79 79 52 52 58 59 55 63 52 52 68 52 60 0 0 
0 0 0 0 63 52 68 68 68 68 79 79 79 79 79 79 79 68 65 68 68 79 79 79 79 79 68 68 68 68 68 79 79 79 79 79 79 68 68 52 52 58 57 52 68 68 52 60 0 0 
0 0 0 0 63 52 68 68 68 68 79 68 68 68 65 65 65 65 65 65 68 68 68 68 68 79 79 79 79 79 79 68 68 68 68 68 79 79 68 68 68 52 52 68 68 68 52 60 0 0 
0 0 0 0 54 61 52 68 68 68 79 68 68 68 68 68 68 68 65 68 68 68 68 68 68 68 79 79 79 79 79 68 68 68 79 79 79 79 68 68 68 79 68 68 68 68 52 60 0 0 
0 0 0 0 0 54 61 52 68 68 68 68 68 68 68 68 68 68 65 65 65 65 65 65 68 68 68 68 68 79 79 79 79 79 79 79 79 79 68 68 68 79 79 68 68 79 52 60 0 0 
0 0 0 0 0 0 63 52 68 68 68 68 68 68 79 79 79 68 68 68 65 65 65 65 65 65 65 68 68 68 68 68 68 68 68 68 68 79 68 79 79 79 79 79 79 79 52 60 0 0 
0 0 0 0 0 56 57 52 68 68 79 68 68 68 79 79 79 68 68 68 65 65 65 65 65 65 65 65 65 65 65 65 65 65 65 65 68 68 68 79 79 79 79 79 79 79 52 60 0 0 
0 0 0 0 56 57 52 52 68 79 79 79 68 79 79 79 79 79 79 68 65 65 65 65 65 65 65 65 65 65 65 65 65 65 65 65 68 68 79 79 79 79 79 79 79 68 52 60 0 0 
0 0 0 0 63 52 68 68 79 79 79 79 79 79 79 68 79 79 79 68 65 65 65 80 80 80 80 80 80 80 80 80 80 68 65 65 68 79 79 79 79 79 79 68 68 68 52 60 0 0 
0 0 0 0 63 52 79 68 79 79 79 79 79 68 79 79 79 79 79 68 65 65 65 65 80 80 80 79 80 80 80 80 80 80 65 65 68 79 68 68 68 79 68 68 65 65 52 60 0 0 
0 0 0 0 63 52 79 68 79 68 68 79 79 79 79 79 79 79 68 68 65 65 65 65 65 80 80 79 79 79 79 79 79 79 65 65 68 79 79 79 79 79 68 68 65 65 52 60 0 0 
0 0 0 0 63 52 79 79 79 79 79 79 79 79 79 79 79 79 68 68 65 65 65 65 65 80 80 79 80 79 79 79 80 79 65 65 65 65 68 79 68 68 68 68 65 65 52 60 0 0 
0 0 0 0 63 52 52 68 68 68 65 65 65 65 65 65 65 65 65 65 65 65 65 65 65 80 80 80 80 80 80 79 79 79 65 65 65 65 65 79 68 68 68 52 52 52 52 60 0 0 
0 0 0 0 54 62 61 52 68 68 65 68 79 79 79 68 68 65 65 65 65 65 65 65 65 80 80 80 80 80 80 80 79 80 80 80 65 65 65 79 68 68 52 52 64 62 62 53 0 0 
0 0 0 0 56 59 57 52 68 68 65 68 68 79 79 79 79 65 65 65 65 65 65 65 65 80 80 80 80 80 80 80 80 80 80 80 68 68 68 68 52 52 64 62 53 0 0 0 0 0 
0 0 0 0 63 52 52 52 68 68 65 68 68 79 79 79 79 65 65 65 65 65 65 65 79 79 79 79 79 79 79 80 80 79 80 80 65 65 65 52 52 64 53 0 0 0 0 0 0 0 
0 0 0 0 63 52 68 68 79 68 65 68 68 79 79 79 68 65 65 65 65 65 65 65 80 79 79 79 79 79 79 79 79 79 80 80 65 65 65 52 64 53 0 0 0 0 0 0 0 0 
0 0 0 0 63 52 68 68 79 68 65 65 68 68 68 68 68 65 65 65 65 65 80 80 80 80 79 79 79 79 80 79 80 79 80 80 65 65 65 52 58 59 59 59 55 0 0 0 0 0 
0 0 0 0 63 52 68 68 79 68 65 65 68 65 65 65 65 65 65 65 65 65 80 80 80 80 79 80 79 79 79 79 79 79 80 80 68 65 65 65 65 65 52 52 58 55 0 0 0 0 
0 0 0 0 63 52 68 68 79 68 65 65 68 65 65 65 65 65 65 65 65 65 65 80 80 80 80 79 79 79 79 79 79 79 80 80 68 68 68 68 65 65 65 52 52 58 55 0 0 0 
0 0 0 0 63 52 68 79 79 68 68 68 68 68 68 68 68 68 68 65 65 65 65 68 68 79 80 79 79 79 79 79 79 79 79 79 79 80 68 68 68 65 65 65 65 52 60 0 0 0 
0 0 0 0 54 61 52 79 79 79 79 68 68 68 68 68 79 68 68 68 65 65 65 65 68 79 80 79 79 79 79 79 79 79 79 80 80 68 68 68 68 68 68 65 65 52 60 0 0 0 
0 0 0 0 0 63 52 68 68 68 68 68 68 68 68 68 79 68 68 65 65 65 65 65 68 79 79 80 80 80 80 80 80 80 80 80 68 68 68 68 68 68 68 65 65 52 60 0 0 0 
0 0 0 0 0 63 52 68 68 68 68 68 68 68 68 79 79 68 68 65 65 65 65 65 68 80 79 79 79 79 79 80 80 80 80 80 80 68 68 68 68 68 68 52 52 52 60 0 0 0 
0 0 0 0 0 54 61 52 68 68 68 68 68 79 68 79 79 79 68 65 65 65 68 68 80 79 79 79 79 79 79 79 68 65 68 80 68 68 65 65 65 65 65 52 64 62 53 0 0 0 
0 0 0 0 0 0 54 61 52 68 68 79 79 79 79 79 68 68 65 65 65 65 79 79 79 79 80 80 80 80 80 68 68 65 65 65 65 65 65 65 65 65 65 52 60 0 0 0 0 0 
0 0 0 0 0 0 0 63 52 68 68 79 79 79 79 79 68 68 65 65 65 65 65 79 79 80 65 65 65 65 65 65 65 65 65 65 65 65 65 65 65 65 65 52 58 55 0 0 0 0 
0 0 0 0 0 0 0 63 52 68 68 79 79 79 68 68 68 65 65 65 65 65 65 65 65 65 65 65 65 65 65 65 65 65 65 65 65 65 65 65 65 65 65 52 52 60 0 0 0 0 
0 0 0 0 0 0 56 57 52 79 79 79 68 65 65 65 65 65 68 68 68 68 68 68 79 79 79 68 68 68 68 68 68 65 65 65 78 78 78 78 78 78 78 78 52 60 0 0 0 0 
0 0 0 0 0 56 57 52 65 79 65 65 65 65 65 68 68 68 68 68 68 68 68 79 79 79 79 68 68 68 68 68 68 65 78 78 78 78 78 78 78 78 78 78 52 60 0 0 0 0 
0 0 0 0 0 63 52 68 68 68 68 68 65 65 68 68 68 68 68 68 68 68 79 79 79 79 79 79 79 79 68 68 68 65 65 78 78 78 78 78 78 78 78 78 52 60 0 0 0 0 
0 0 0 0 0 63 52 68 68 68 68 68 65 65 68 68 68 68 68 79 79 68 79 79 79 79 79 79 79 68 65 79 68 68 65 78 78 78 78 78 78 78 78 78 52 58 59 55 0 0 
0 0 0 0 0 63 52 68 68 68 68 68 68 65 79 79 79 79 79 79 68 68 68 68 68 79 68 68 68 68 65 79 79 68 65 78 78 78 78 78 78 78 78 78 52 52 52 60 0 0 
0 0 0 0 0 63 52 68 68 68 68 68 68 79 79 65 65 65 65 65 65 65 65 65 65 68 65 65 65 65 65 79 79 79 79 78 78 78 78 78 78 78 78 78 78 78 52 60 0 0 
0 0 0 0 0 63 52 68 68 68 68 68 52 52 52 52 52 52 52 52 52 52 52 65 65 68 65 52 52 52 52 52 52 52 65 65 65 65 65 65 65 78 78 78 78 37 52 60 0 0 
0 0 0 0 0 54 61 52 52 52 52 52 52 64 62 62 62 62 62 62 61 52 52 52 52 68 52 64 62 62 62 62 61 52 52 52 52 52 52 52 52 52 52 52 52 52 52 60 0 0 
0 0 0 0 0 0 54 62 62 62 62 62 62 53 0 0 0 0 0 0 54 62 62 61 52 68 52 60 0 0 0 0 54 62 62 62 62 62 62 62 62 62 62 62 62 62 62 53 0 0 
0 0 0 0 0 0 0 0 0 0 0 0 0 0 0 0 0 0 0 0 0 0 0 63 52 52 52 60 0 0 0 0 0 0 0 0 0 0 0 0 0 0 0 0 0 0 0 0 0 0 
0 0 0 0 0 0 0 0 0 0 0 0 0 0 0 0 0 0 0 0 0 0 0 54 62 62 62 53 0 0 0 0 0 0 0 0 0 0 0 0 0 0 0 0 0 0 0 0 0 0 
0 0 0 0 0 0 0 0 0 0 0 0 0 0 0 0 0 0 0 0 0 0 0 0 0 0 0 0 0 0 0 0 0 0 0 0 0 0 0 0 0 0 0 0 0 0 0 0 0 0 
0 0 0 0 0 0 0 0 0 0 0 0 0 0 0 0 0 0 0 0 0 0 0 0 0 0 0 0 0 0 0 0 0 0 0 0 0 0 0 0 0 0 0 0 0 0 0 0 0 0 
0 0 0 0 0 0 0 0 0 0 0 0 0 0 0 0 0 0 0 0 0 0 0 0 0 0 0 0 0 0 0 0 0 0 0 0 0 0 0 0 0 0 0 0 0 0 0 0 0 0 
