18 18 18 18 18 18 18 18 18 18 18 18 18 18 18 18 18 18 18 18 18 18 18 18 18 18 18 18 18 18 18 18 18 18 18 18 18 18 18 18 18 18 18 18 18 18 18 18 18 18 
19 19 19 19 19 19 19 19 19 19 19 19 19 19 19 18 18 18 18 18 18 18 18 18 19 19 19 19 19 19 19 19 19 19 18 18 19 19 18 18 18 18 19 19 18 18 18 18 18 18 
19 19 19 18 18 18 18 19 18 18 18 18 18 18 18 19 18 18 18 18 18 18 18 28 26 26 26 26 26 26 26 26 26 26 26 26 26 26 26 26 29 18 18 18 19 19 19 19 19 18 
19 19 18 18 18 19 18 19 18 18 18 19 19 18 18 18 18 18 18 18 18 18 18 24 1 1 1 1 1 1 1 1 1 1 1 16 16 16 16 16 23 19 18 18 18 18 19 19 19 18 
19 19 18 18 18 18 18 18 18 18 18 18 19 18 19 19 18 28 26 26 26 26 26 27 1 1 1 1 1 1 1 1 1 1 1 16 16 16 16 16 23 19 18 18 19 18 18 18 18 18 
19 19 18 18 18 18 18 19 18 18 18 18 18 19 19 18 18 24 1 1 1 1 1 1 1 1 1 1 1 1 1 1 1 1 1 16 16 16 16 16 25 26 26 26 26 26 29 18 19 18 
19 19 18 18 18 19 19 28 26 26 26 26 26 26 26 26 26 27 1 1 1 1 1 1 1 1 1 1 1 1 1 1 1 1 1 16 16 16 16 16 16 16 16 16 78 36 23 18 18 18 
19 19 18 18 18 19 19 24 1 1 1 1 1 1 1 1 1 1 1 1 1 1 1 1 1 1 1 1 1 1 1 1 1 1 1 16 16 16 16 16 16 16 16 16 79 79 23 19 18 18 
19 18 18 18 19 19 19 24 1 1 1 1 1 1 1 1 1 1 1 1 1 1 1 1 1 1 1 1 1 1 1 1 1 1 1 16 16 16 16 16 16 16 16 16 79 79 23 19 18 19 
19 19 19 18 19 19 19 24 1 1 1 1 1 85 85 85 2 2 2 2 85 85 85 85 85 1 1 1 1 1 1 1 1 1 1 16 79 79 78 79 78 78 78 79 78 78 23 19 18 19 
19 19 19 18 18 18 19 24 1 1 1 1 1 1 1 2 2 2 2 1 1 1 1 1 1 1 1 1 1 1 1 1 1 1 1 16 79 78 78 79 78 79 79 79 78 79 23 19 19 19 
19 19 19 19 18 19 19 24 1 1 1 1 1 1 1 1 2 2 2 2 1 1 1 1 1 1 1 1 1 1 1 1 1 1 1 16 79 79 78 78 78 79 79 78 79 78 23 19 19 19 
19 19 19 18 19 19 19 24 1 1 1 1 1 1 1 1 2 2 86 86 1 86 1 1 1 1 1 1 1 1 1 1 1 1 1 16 20 21 22 78 79 78 79 78 78 79 23 19 19 19 
19 19 19 18 18 19 19 24 1 1 1 1 1 1 1 1 1 2 86 2 2 1 1 1 1 1 1 1 1 1 1 1 1 1 1 16 23 18 24 78 79 78 79 78 79 79 23 19 19 19 
19 19 19 19 18 18 19 24 1 1 1 1 1 1 1 1 1 1 2 2 2 1 1 1 1 1 1 1 1 1 1 1 1 1 1 16 25 26 27 78 79 78 79 79 78 79 23 19 19 19 
19 18 18 19 18 18 18 24 1 1 1 1 1 1 1 1 1 1 1 2 2 2 1 1 1 85 1 1 1 1 1 1 1 1 1 16 16 16 16 16 79 79 79 16 16 16 23 19 19 19 
19 18 19 19 19 19 18 24 1 1 1 1 1 1 1 1 1 1 1 1 1 1 1 1 1 1 1 1 1 1 1 1 1 1 1 1 1 1 1 1 78 78 78 1 1 1 23 19 18 19 
19 18 18 19 18 19 19 24 1 1 1 1 1 1 1 1 1 1 1 1 1 1 1 1 85 1 1 1 1 1 1 1 1 1 1 1 1 1 1 1 1 1 1 1 1 85 23 19 18 19 
18 18 19 19 19 28 26 27 1 1 1 1 1 1 1 1 1 1 1 1 85 84 84 1 1 1 1 1 1 1 1 1 1 1 1 1 1 1 1 1 2 1 1 1 1 1 23 19 18 18 
19 18 18 18 18 24 83 83 87 87 87 87 1 1 1 1 1 1 1 84 84 84 2 84 84 1 1 1 1 1 1 1 1 1 1 1 1 1 1 1 1 1 1 1 1 1 23 18 18 18 
18 18 18 18 19 24 83 83 87 87 87 87 87 1 1 1 1 1 1 1 84 84 2 84 84 84 1 1 1 1 1 1 1 1 1 1 1 1 1 1 1 1 1 1 20 21 31 18 18 18 
19 19 19 18 18 24 83 83 83 87 87 16 87 16 1 87 83 83 83 87 87 87 87 84 84 84 84 1 1 1 1 1 1 1 1 1 1 1 1 1 1 1 1 1 23 18 18 18 18 19 
18 18 18 18 18 24 83 16 16 16 16 16 87 16 16 83 83 83 87 83 87 87 87 84 84 84 84 84 84 1 1 1 1 1 1 1 1 1 1 1 1 1 1 1 23 18 18 18 18 19 
18 18 18 19 18 24 16 16 16 16 16 16 16 16 16 83 83 83 85 87 16 16 16 16 16 16 16 16 16 1 1 1 1 1 1 1 1 1 1 1 1 1 1 1 23 18 18 18 18 18 
19 19 18 19 18 24 16 16 16 16 16 16 16 16 16 16 16 16 16 16 16 16 16 16 16 16 16 16 1 1 1 1 1 1 1 1 1 1 1 1 1 1 1 1 23 18 18 18 18 18 
19 19 18 19 19 24 16 16 16 16 16 16 16 83 83 83 83 1 84 2 16 16 16 16 16 16 16 16 16 1 1 1 1 1 1 1 1 1 1 1 1 1 1 1 23 19 19 19 19 19 
19 18 18 18 18 24 16 16 16 16 84 84 83 83 84 1 1 84 1 85 84 16 16 16 16 16 16 16 16 1 1 1 1 1 1 1 1 1 1 1 1 1 1 1 23 19 19 19 19 19 
18 18 19 18 18 24 16 16 16 16 84 73 81 74 73 81 74 73 81 74 84 16 16 16 16 16 1 16 16 1 1 1 1 1 1 1 1 1 1 1 1 1 1 1 23 19 18 18 18 19 
19 19 19 19 19 24 16 16 84 84 83 76 82 75 76 82 75 76 82 75 84 84 84 84 84 1 1 16 1 1 1 1 1 1 1 1 1 1 1 1 1 1 20 21 31 19 18 18 18 18 
18 18 18 18 18 24 1 16 1 84 83 83 3 83 84 3 84 84 3 83 84 84 87 87 87 87 1 1 1 1 1 1 1 1 1 1 1 1 1 1 1 1 23 18 18 18 18 18 18 18 
19 19 19 19 19 24 1 16 1 84 83 83 3 1 83 3 84 84 3 83 84 84 88 92 90 87 87 1 1 1 1 1 1 1 1 1 1 1 1 1 1 1 23 18 19 18 18 18 18 18 
19 19 19 19 19 24 1 1 83 83 87 83 3 83 83 3 84 84 3 84 84 87 89 93 91 87 87 1 1 1 1 1 1 1 1 1 1 1 1 1 1 1 23 18 19 18 19 19 18 18 
19 19 19 19 19 24 1 1 1 1 2 87 3 3 3 3 3 3 3 83 83 84 83 83 84 87 87 1 1 1 1 1 1 1 1 1 1 1 1 1 1 1 23 19 19 18 18 19 18 18 
18 18 18 18 18 24 1 1 1 1 83 88 92 90 88 92 90 88 92 90 83 84 84 84 84 1 1 1 1 1 1 1 1 1 1 1 1 1 1 1 1 1 23 18 19 18 18 18 18 18 
18 18 18 18 18 24 1 1 1 1 83 89 93 91 89 93 91 89 93 91 83 83 84 83 83 1 1 1 1 1 1 1 1 1 1 1 1 1 1 1 1 1 23 18 18 18 18 18 18 18 
18 18 18 18 18 24 1 1 1 1 83 83 3 83 84 3 83 83 3 83 83 83 83 83 83 1 1 1 1 1 1 1 1 1 1 1 1 1 1 1 1 1 23 19 18 18 18 18 18 18 
18 18 18 18 18 30 21 22 1 1 83 83 3 84 83 3 84 87 3 83 83 88 92 90 83 1 1 1 1 1 1 1 1 1 1 1 1 1 1 1 1 1 23 19 19 19 19 19 19 19 
18 18 18 18 18 18 18 24 1 1 1 83 3 84 87 3 84 84 3 85 84 89 93 91 87 1 1 1 1 1 1 1 1 1 1 1 1 1 1 1 1 1 23 19 19 19 19 19 19 19 
18 18 18 18 18 18 18 24 1 1 1 83 3 87 83 3 84 84 3 1 85 84 84 87 87 1 1 1 1 1 1 1 1 1 1 1 1 1 1 1 1 1 23 18 18 19 19 19 19 19 
18 18 18 18 18 18 18 24 1 1 1 73 81 74 88 92 90 73 81 74 87 85 87 87 87 1 1 1 1 1 1 1 1 1 1 1 1 1 1 1 1 1 23 18 18 18 18 18 18 18 
18 18 18 18 18 18 18 24 1 1 1 76 82 75 89 93 91 76 82 75 85 85 85 85 85 1 1 1 1 1 1 1 1 1 1 1 1 1 1 1 1 1 23 18 19 18 18 18 18 18 
18 18 18 18 18 18 18 24 1 1 1 83 3 84 84 3 83 83 3 1 85 85 85 85 85 1 1 1 1 1 1 1 1 1 1 1 1 1 1 1 1 1 23 18 19 18 19 19 19 19 
19 19 19 19 19 19 19 24 1 1 1 83 3 87 84 3 83 87 3 1 85 85 85 85 85 1 1 1 1 1 1 1 1 1 1 1 1 1 1 1 20 21 31 18 18 18 18 18 18 18 
18 18 18 18 18 18 19 24 3 3 3 3 3 3 3 3 3 3 3 1 1 1 1 1 20 21 21 21 21 21 21 21 21 21 21 21 21 21 21 21 31 18 18 19 18 18 18 18 18 18 
18 19 19 19 19 18 18 30 97 98 99 21 21 21 21 21 21 21 21 21 21 21 21 21 31 18 18 18 18 18 18 19 19 19 18 18 18 18 18 18 18 18 18 18 18 18 19 18 18 18 
18 18 18 19 19 19 19 19 97 98 99 19 19 19 19 19 19 19 19 19 18 19 18 18 18 18 18 18 18 18 18 19 19 18 18 18 18 18 18 18 18 18 18 19 19 19 18 18 18 18 
19 19 18 18 18 18 18 18 94 96 95 19 19 19 19 19 19 19 19 19 18 18 18 18 18 18 19 19 19 19 18 19 19 19 18 18 18 18 18 18 18 18 18 18 18 18 18 18 18 19 
18 18 18 18 18 18 18 18 18 18 18 18 18 18 18 18 18 18 18 18 18 18 18 18 18 18 18 18 18 18 18 18 18 18 18 18 18 18 18 18 18 18 18 18 18 18 18 18 18 18 
18 18 18 18 18 18 18 18 18 18 18 18 18 18 18 18 18 18 18 18 18 18 18 18 18 18 18 18 18 18 18 18 18 18 18 18 18 18 18 18 18 18 18 18 18 18 18 18 18 18 
18 18 18 18 18 18 18 18 18 18 18 18 18 18 18 18 18 18 18 18 18 18 18 18 18 18 18 18 18 18 18 18 18 18 18 18 18 18 18 18 18 18 18 18 18 18 18 18 18 18 
