18 18 18 18 18 18 18 18 18 18 18 18 18 18 18 18 18 18 18 18 18 18 18 18 18 18 18 18 18 18 18 18 18 18 18 18 18 18 18 18 18 18 18 18 18 18 18 18 18 18 
19 19 19 19 19 19 19 19 19 19 19 19 19 19 19 18 18 18 18 18 18 18 18 18 19 19 19 19 19 19 19 19 19 19 18 18 19 19 18 18 18 18 19 19 18 18 18 18 18 18 
19 19 19 18 18 18 18 19 18 18 18 18 18 18 18 19 18 18 18 18 18 18 18 28 26 26 26 26 26 26 26 26 26 26 206 206 206 206 206 206 208 18 18 18 19 19 19 19 19 18 
19 19 18 18 18 19 18 19 18 18 18 19 19 18 18 18 18 18 18 18 18 18 18 24 16 16 16 16 16 16 16 16 16 16 78 78 78 78 78 78 207 19 18 18 18 18 19 19 19 18 
19 19 18 18 18 18 18 18 18 18 18 18 19 18 19 19 18 28 26 26 26 26 26 27 16 16 16 84 16 16 16 16 16 78 78 78 78 78 78 78 207 19 18 18 19 18 18 18 18 18 
19 19 18 18 18 18 18 19 18 18 18 18 18 19 19 18 18 24 83 84 16 16 16 16 16 16 84 84 16 16 16 16 16 78 78 78 78 78 78 78 211 206 206 206 206 206 208 18 19 18 
19 19 18 18 18 19 19 28 26 26 26 26 26 26 26 26 26 27 84 83 16 16 16 16 16 84 84 84 84 84 16 16 16 78 78 78 78 78 78 78 78 78 79 79 79 36 207 18 18 18 
19 19 18 18 18 19 19 24 16 16 16 16 16 16 16 16 16 16 16 1 16 16 16 16 16 83 84 84 84 84 1 16 16 16 78 78 78 78 78 78 78 78 79 79 79 78 207 19 18 18 
19 18 18 18 19 19 19 24 87 1 87 1 1 1 1 1 1 1 1 1 16 84 84 84 83 83 83 83 83 83 83 1 16 16 78 78 78 78 79 79 78 78 79 79 79 78 207 19 18 19 
19 19 19 18 19 19 19 24 1 1 1 16 16 16 1 1 1 1 1 84 84 84 83 83 84 83 83 83 83 84 83 1 1 16 78 78 78 78 78 79 79 78 79 79 79 78 207 19 18 19 
19 19 19 18 18 18 19 24 87 1 84 1 16 16 16 16 16 1 1 1 83 83 83 83 83 83 83 83 83 83 83 1 1 16 16 78 78 78 78 79 79 79 79 79 79 78 207 19 19 19 
19 19 19 19 18 19 19 24 1 87 86 16 16 16 16 16 16 1 1 1 1 1 16 16 83 83 83 83 83 83 83 83 1 16 16 79 79 79 79 79 79 79 79 79 79 78 207 19 19 19 
19 19 19 18 19 19 19 24 1 1 1 16 16 16 16 16 16 2 86 86 16 16 16 1 1 1 16 16 16 16 1 1 1 16 16 78 79 79 79 79 79 68 68 68 79 78 207 19 19 19 
19 19 19 18 18 19 19 24 1 1 16 16 16 1 86 16 16 16 16 16 16 1 1 1 1 16 16 16 16 16 1 1 1 16 16 78 79 79 79 79 68 68 68 68 68 78 207 19 19 19 
19 19 19 19 18 18 19 24 1 1 16 16 16 1 16 16 16 16 16 16 16 1 1 1 1 16 16 16 16 16 1 1 1 16 16 78 79 79 79 79 68 68 68 68 68 78 207 19 19 19 
19 18 18 19 18 18 18 24 86 1 87 1 1 1 1 16 16 16 16 16 2 2 1 16 16 16 16 16 16 16 1 84 1 1 1 78 78 78 78 79 79 79 68 68 68 78 207 19 19 19 
19 18 19 19 19 19 18 24 16 16 16 16 16 16 16 16 16 16 1 1 1 1 1 1 1 16 16 16 16 16 16 1 1 1 1 78 78 78 78 79 79 79 79 68 78 78 207 19 18 19 
19 18 18 19 18 19 19 24 16 16 16 16 16 16 16 16 16 16 16 16 16 1 2 1 1 16 16 16 16 16 16 1 1 1 2 78 78 78 79 79 79 79 79 79 79 78 207 19 18 19 
18 18 19 19 19 28 26 27 16 16 16 16 16 16 16 16 16 16 16 16 16 16 16 1 87 1 1 2 16 16 16 1 16 83 1 1 78 78 79 79 78 79 78 78 78 78 207 19 18 18 
19 18 18 18 18 24 16 16 16 16 16 16 83 83 173 174 175 87 83 83 16 16 16 16 1 1 1 1 1 1 16 2 16 1 1 1 78 79 79 78 79 1 2 1 1 1 207 18 18 18 
18 18 18 18 19 24 16 16 16 16 16 16 83 83 179 180 181 83 83 83 16 16 16 16 1 1 1 1 12 10 10 10 10 10 10 13 210 210 210 210 210 1 1 1 20 21 209 18 18 18 
19 19 19 18 18 24 16 16 16 16 16 16 86 86 176 177 178 83 86 83 16 16 16 16 16 2 1 1 8 3 3 3 3 3 3 7 1 16 16 1 16 16 1 1 23 18 18 18 18 19 
18 18 18 18 18 24 16 16 16 16 16 86 86 87 8 3 7 83 83 86 16 16 16 16 16 1 1 1 8 3 3 3 3 3 3 7 1 16 16 16 16 1 2 1 23 18 18 18 18 19 
18 18 18 19 18 24 16 16 16 16 16 84 84 87 8 3 7 87 83 86 16 16 16 16 16 16 16 16 8 3 3 4 5 5 5 15 1 1 16 16 16 1 1 16 23 18 18 18 18 18 
19 19 18 19 18 24 16 16 16 16 16 84 86 84 8 3 7 83 83 83 16 16 16 16 16 16 16 16 8 3 3 7 1 1 1 1 1 83 16 16 1 2 16 16 23 18 18 18 18 18 
19 19 18 19 19 24 16 16 16 16 16 84 84 83 8 3 7 84 84 2 16 16 16 16 16 16 16 16 8 3 3 7 16 16 16 16 1 1 16 1 1 1 16 16 23 19 19 19 19 19 
19 18 18 18 18 24 16 16 16 16 1 1 1 1 8 3 7 1 1 1 1 16 16 16 16 16 16 16 8 3 3 7 16 16 16 16 1 1 1 2 1 1 16 16 23 19 19 19 19 19 
18 18 19 18 18 24 16 16 16 16 1 1 84 1 8 3 7 84 84 1 1 16 16 16 16 16 1 16 8 3 3 7 16 16 16 16 1 1 1 1 1 1 1 16 23 19 18 18 18 19 
19 19 19 19 19 24 16 16 84 84 1 1 84 1 8 3 7 1 84 1 1 84 84 84 84 1 1 16 14 5 5 15 1 16 16 16 1 1 1 1 16 16 20 21 31 19 18 18 18 18 
18 18 18 18 18 24 1 16 1 84 1 1 84 1 8 3 7 1 1 1 1 84 87 1 1 87 1 1 1 1 1 1 83 16 16 16 1 1 16 16 16 16 23 18 18 18 18 18 18 18 
19 19 19 19 19 24 1 16 1 1 1 84 84 83 8 3 7 1 1 1 1 1 1 1 83 1 87 1 1 83 1 1 1 16 16 1 1 16 16 16 16 16 23 18 19 18 18 18 18 18 
19 19 19 19 19 24 1 1 83 1 84 84 84 83 8 3 7 1 88 92 90 1 1 83 83 87 87 1 1 1 1 1 1 16 16 1 1 1 16 16 16 1 23 18 19 18 19 19 18 18 
19 19 19 19 19 24 1 1 1 1 1 83 84 84 8 3 7 85 89 93 91 83 1 1 83 83 83 83 1 1 1 1 1 16 16 1 1 1 1 1 1 2 23 19 19 18 18 19 18 18 
18 18 18 18 18 24 1 1 1 1 83 88 92 90 8 3 7 1 8 3 7 1 83 1 1 1 84 1 1 1 1 1 1 16 16 1 1 1 1 1 1 1 23 18 19 18 18 18 18 18 
18 18 18 18 18 24 1 1 1 1 83 89 93 91 8 3 7 1 8 3 7 1 83 1 1 84 84 1 1 1 1 1 1 16 16 1 83 1 16 16 16 1 23 18 18 18 18 18 18 18 
18 18 18 18 18 24 1 1 1 1 84 8 3 7 8 3 7 1 14 5 15 83 83 83 1 84 84 1 1 1 1 1 1 16 16 83 83 83 84 16 16 16 23 19 18 18 18 18 18 18 
18 18 18 18 18 30 21 22 1 1 83 8 3 7 8 3 7 1 1 1 83 73 81 74 83 1 1 1 1 1 1 1 1 16 16 84 83 83 84 84 16 16 23 19 19 19 19 19 19 19 
18 18 18 18 18 18 18 24 1 1 1 8 3 7 8 3 7 1 1 1 84 76 82 75 87 12 10 10 10 10 10 10 10 16 16 84 83 83 83 84 84 16 23 19 19 19 19 19 19 19 
18 18 18 18 18 18 18 24 1 84 84 8 3 7 14 5 15 1 1 1 85 8 3 7 87 8 3 3 3 3 108 108 108 16 16 84 84 84 84 83 84 16 23 18 18 19 19 19 19 19 
18 18 18 18 18 18 18 24 1 84 84 8 3 7 1 83 1 1 1 1 87 8 3 7 87 8 3 3 20 21 109 110 111 21 22 84 83 83 84 83 84 16 23 18 18 18 18 18 18 18 
18 18 18 18 18 18 18 24 1 1 1 8 3 7 1 83 83 1 1 1 85 8 3 7 85 8 3 3 23 18 109 110 111 18 24 83 84 83 84 83 83 83 23 18 19 18 18 18 18 18 
18 18 18 18 18 18 18 24 1 1 1 8 3 7 1 1 1 1 1 1 85 8 3 9 10 11 3 3 23 18 109 110 111 18 24 83 83 84 84 84 83 83 23 18 19 18 19 19 19 19 
19 19 19 19 19 19 19 24 10 10 10 11 3 9 10 10 10 10 10 10 10 11 3 3 3 3 3 3 23 94 95 96 97 98 24 83 83 83 83 83 20 21 31 18 18 18 18 18 18 18 
18 18 18 18 18 18 19 24 108 108 108 108 108 108 108 108 108 108 108 108 108 108 108 108 20 21 21 21 31 18 18 18 18 18 30 21 21 21 21 21 31 18 18 19 18 18 18 18 18 18 
18 19 19 19 19 18 18 30 21 21 21 21 21 21 21 21 21 21 21 21 21 21 21 21 31 18 18 18 18 18 18 19 19 19 18 18 18 18 18 18 18 18 18 18 18 18 19 18 18 18 
18 18 18 19 19 19 19 18 18 18 18 18 19 19 19 19 19 19 19 19 18 19 18 18 18 18 18 18 18 18 18 19 19 18 18 18 18 18 18 18 18 18 18 19 19 19 18 18 18 18 
19 19 18 18 18 18 18 18 18 18 18 18 19 19 19 19 19 19 19 19 18 18 18 18 18 18 19 19 19 19 18 19 19 19 18 18 18 18 18 18 18 18 18 18 18 18 18 18 18 19 
18 18 18 18 18 18 18 18 18 18 18 18 18 18 18 18 18 18 18 18 18 18 18 18 18 18 18 18 18 18 18 18 18 18 18 18 18 18 18 18 18 18 18 18 18 18 18 18 18 18 
18 18 18 18 18 18 18 18 18 18 18 18 18 18 18 18 18 18 18 18 18 18 18 18 18 18 18 18 18 18 18 18 18 18 18 18 18 18 18 18 18 18 18 18 18 18 18 18 18 18 
18 18 18 18 18 18 18 18 18 18 18 18 18 18 18 18 18 18 18 18 18 18 18 18 18 18 18 18 18 18 18 18 18 18 18 18 18 18 18 18 18 18 18 18 18 18 18 18 18 18 
